11111111111111111111
10000000010000010001
10110111000111000111
11110000111005111001
11060111000010040001
11014100011001100101
10010001000010100101
10110110111000001001
14000110100601100011
10100000101101111001
10111110500040000111
10000010101001110011
11110100101000001011
10110104100110100001
10600101101100101001
10111101000061001001
10100001010101110011
10101011010101105101
10001000010000000001
12111111111111111111