11111111111111111111
10000000010000010001
10110111000111000111
11110000111000111001
11000111000010040001
11014100011001100101
10010001000010100101
10110110111000001001
14000110100001100011
10100000101101111001
10111110000040000111
10000010101001110011
11110100101000001011
10110104100110100001
10000101101100101001
10111101000001001001
10100001010101110011
10101011010101100101
10001000010000000001
11111111111111111111