1111111101
1000111001
1101000011
1100010101
1001110001
1101001011
1000011001
1011101101
1000000001
1011111111